..............
...#..........
....#.........
..###.........
..............
..............
..............