^^^^^^^^^^^^^^
^^^#^^^^^^^^^^
^^^^#^^^^^^^^^
^^###^^^^^^^^^
^^^^^^^^^^^^^^
^^^^^^^^^^^^^^
^^^^^^^^^^^^^^